ResID,Resname,Longest contact (frames),Longest contact (ps),Contact first frame,Contact last frame
112,ASN,24,480,1344,1368
113,PRO,7,140,168,175
114,SER,96,1920,1344,1440
115,GLN,169,3380,395,564
116,GLN,1,20,104,105
117,LEU,104,2080,95,199
118,ALA,700,14000,0,700
119,ILE,43,860,1292,1335
120,ALA,9,180,1464,1473
121,VAL,191,3820,0,191
122,LEU,289,5780,515,804
123,SER,2,40,865,867
124,LEU,44,880,290,334
125,THR,153,3060,815,968
126,LEU,42,840,548,590
127,GLY,6,120,833,839
128,THR,164,3280,616,780
129,PHE,414,8280,482,896
131,VAL,60,1200,825,885
132,LEU,226,4520,616,842
133,GLU,70,1400,1288,1358
134,ASN,1,20,813,814
135,LEU,29,580,807,836
136,LEU,22,440,1323,1345
139,CYS,54,1080,779,833
142,LEU,5,100,598,603
143,HIS,60,1200,772,832
148,ARG,3,60,859,862
155,PHE,1,20,117,118
164,LEU,20,400,811,831
165,LEU,2,40,823,825
168,VAL,58,1160,853,911
169,ILE,1,20,35,36
171,VAL,57,1140,853,910
172,TYR,39,780,853,892
175,ILE,11,220,862,873
179,VAL,5,100,1456,1461
180,PHE,17,340,1463,1480
186,ARG,1,20,56,57
187,ASN,2,40,38,40
191,PHE,58,1160,32,90
197,THR,22,440,1055,1077
198,ALA,1,20,1015,1016
200,PHE,1,20,475,476
201,THR,241,4820,952,1193
202,ALA,17,340,818,835
204,VAL,8,160,1040,1048
205,GLY,300,6000,859,1159
206,SER,4,80,947,951
208,PHE,372,7440,744,1116
209,LEU,250,5000,1178,1428
211,ALA,1,20,1028,1029
212,ILE,365,7300,572,937
213,ASP,6,120,739,745
215,TYR,50,1000,651,701
216,ILE,13,260,732,745
219,HIS,22,440,318,340
220,ARG,16,320,316,332
223,ALA,1,20,3,4
226,ARG,27,540,113,140
227,ILE,100,2000,0,100
228,VAL,25,500,684,709
229,THR,7,140,149,156
231,PRO,50,1000,229,279
232,LYS,432,8640,0,432
233,ALA,3,60,134,137
235,VAL,106,2120,117,223
236,ALA,341,6820,0,341
237,PHE,6,120,608,614
238,CYS,2,40,810,812
239,LEU,147,2940,1209,1356
240,MET,342,6840,1036,1378
241,TRP,1,20,7,8
242,THR,39,780,763,802
243,ILE,1438,28760,0,1438
244,ALA,161,3220,972,1133
245,ILE,23,460,879,902
246,VAL,344,6880,616,960
247,ILE,683,13660,117,800
248,ALA,33,660,1055,1088
249,VAL,64,1280,1114,1178
251,PRO,8,160,1211,1219
252,LEU,1,20,129,130
253,LEU,166,3320,1127,1293
254,GLY,172,3440,1104,1276
259,LYS,15,300,1166,1181
260,LEU,50,1000,1435,1485
274,THR,1,20,7,8
275,TYR,8,160,1039,1047
277,MET,18,360,454,472
278,PHE,453,9060,0,453
279,TRP,205,4100,984,1189
280,ILE,8,160,418,426
281,GLY,73,1460,379,452
282,VAL,394,7880,863,1257
283,VAL,18,360,885,903
284,SER,18,360,471,489
285,VAL,76,1520,476,552
286,LEU,80,1600,1162,1242
287,LEU,47,940,588,635
288,LEU,119,2380,431,550
289,PHE,21,420,271,292
291,VAL,157,3140,495,652
292,TYR,488,9760,632,1120
293,ALA,5,100,1334,1339
295,MET,516,10320,214,730
296,TYR,238,4760,638,876
298,LEU,22,440,412,434
299,TRP,450,9000,232,682
300,LYS,42,840,952,994
302,HIS,19,380,452,471
303,SER,5,100,1147,1152
343,LYS,23,460,1,24
344,THR,1,20,75,76
346,VAL,7,140,180,187
347,LEU,793,15860,0,793
348,ILE,1,20,184,185
350,VAL,537,10740,75,612
351,VAL,1403,28060,0,1403
352,LEU,1,20,9,10
353,ILE,107,2140,417,524
354,ILE,258,5160,553,811
355,CYS,500,10000,300,800
356,TRP,2,40,435,437
357,GLY,76,1520,430,506
358,PRO,787,15740,0,787
359,LEU,3,60,953,956
360,LEU,69,1380,448,517
361,ALA,231,4620,392,623
362,ILE,121,2420,654,775
364,VAL,5,100,1453,1458
365,TYR,253,5060,1108,1361
367,VAL,3,60,420,423
368,PHE,2,40,260,262
370,LYS,2,40,820,822
371,MET,1,20,525,526
372,ASN,75,1500,575,650
374,LEU,190,3800,574,764
375,ILE,204,4080,239,443
377,THR,3,60,172,175
378,VAL,321,6420,728,1049
379,PHE,2,40,867,869
380,ALA,3,60,937,940
381,PHE,671,13420,785,1456
382,CYS,302,6040,791,1093
384,MET,95,1900,504,599
385,LEU,130,2600,885,1015
386,CYS,1,20,298,299
388,LEU,466,9320,277,743
389,ASN,17,340,1363,1380
391,THR,51,1020,603,654
392,VAL,214,4280,1115,1329
395,ILE,81,1620,922,1003
398,ALA,7,140,1194,1201
399,LEU,91,1820,922,1013
400,ARG,3,60,74,77
405,ARG,2,40,958,960
408,PHE,8,160,1342,1350
411,MET,3,60,782,785
412,PHE,5,100,891,896
413,PRO,6,120,891,897
