ResID,Resname,Longest contact (frames),Longest contact (ps),Contact first frame,Contact last frame
112,ASN,2,40,154,156
114,SER,6,120,443,449
115,GLN,9,180,450,459
117,LEU,2,40,240,242
118,ALA,41,820,1438,1479
119,ILE,1,20,1039,1040
122,LEU,126,2520,1035,1161
123,SER,1,20,22,23
124,LEU,9,180,63,72
125,THR,147,2940,1035,1182
126,LEU,106,2120,1190,1296
127,GLY,73,1460,0,73
128,THR,38,760,36,74
129,PHE,277,5540,903,1180
130,THR,1,20,43,44
131,VAL,35,700,0,35
132,LEU,8,160,1058,1066
133,GLU,73,1460,632,705
135,LEU,60,1200,73,133
136,LEU,29,580,864,893
139,CYS,19,380,1457,1476
140,VAL,1,20,847,848
142,LEU,1,20,485,486
143,HIS,56,1120,1223,1279
145,ARG,1,20,1006,1007
158,SER,88,1760,1138,1226
159,LEU,2,40,1139,1141
161,VAL,113,2260,1114,1227
162,ALA,157,3140,1116,1273
163,ASP,1,20,1269,1270
164,LEU,19,380,717,736
165,LEU,654,13080,694,1348
166,GLY,2,40,1219,1221
167,SER,1,20,30,31
168,VAL,45,900,81,126
169,ILE,51,1020,1398,1449
171,VAL,74,1480,0,74
172,TYR,204,4080,200,404
175,ILE,6,120,5,11
176,ASP,63,1260,115,178
180,PHE,95,1900,109,204
182,ARG,30,600,280,310
184,ASP,44,880,275,319
187,ASN,1,20,1490,1491
188,VAL,6,120,313,319
191,PHE,164,3280,1118,1282
192,LYS,117,2340,242,359
194,GLY,4,80,1145,1149
195,GLY,190,3800,1099,1289
196,VAL,1,20,1107,1108
198,ALA,346,6920,1007,1353
199,SER,142,2840,1090,1232
202,ALA,160,3200,1114,1274
206,SER,2,40,1196,1198
208,PHE,10,200,1281,1291
212,ILE,1,20,1352,1353
215,TYR,4,80,1243,1247
227,ILE,2,40,1358,1360
228,VAL,1,20,1358,1359
232,LYS,32,640,1425,1457
235,VAL,2,40,239,241
237,PHE,2,40,912,914
239,LEU,21,420,213,234
240,MET,2,40,236,238
241,TRP,312,6240,691,1003
242,THR,6,120,1161,1167
243,ILE,33,660,219,252
244,ALA,11,220,1161,1172
245,ILE,658,13160,695,1353
246,VAL,2,40,1019,1021
248,ALA,2,40,1149,1151
249,VAL,2,40,867,869
252,LEU,7,140,1161,1168
255,TRP,7,140,597,604
274,THR,7,140,597,604
277,MET,2,40,429,431
278,PHE,12,240,430,442
279,TRP,1,20,1164,1165
281,GLY,3,60,1180,1183
282,VAL,7,140,1160,1167
284,SER,15,300,125,140
285,VAL,63,1260,380,443
286,LEU,3,60,404,407
287,LEU,10,200,138,148
288,LEU,62,1240,386,448
289,PHE,42,840,392,434
291,VAL,54,1080,710,764
292,TYR,452,9040,154,606
293,ALA,2,40,576,578
294,TYR,13,260,1138,1151
296,TYR,72,1440,456,528
299,TRP,153,3060,1312,1465
300,LYS,6,120,510,516
302,HIS,81,1620,1379,1460
303,SER,3,60,1424,1427
343,LYS,6,120,646,652
345,LEU,1,20,916,917
346,VAL,200,4000,1263,1463
347,LEU,163,3260,639,802
348,ILE,1,20,675,676
349,LEU,203,4060,1118,1321
350,VAL,371,7420,995,1366
351,VAL,88,1760,671,759
354,ILE,129,2580,1210,1339
355,CYS,3,60,323,326
357,GLY,2,40,1378,1380
358,PRO,9,180,323,332
360,LEU,4,80,143,147
361,ALA,7,140,42,49
362,ILE,1,20,260,261
365,TYR,12,240,105,117
368,PHE,80,1600,516,596
372,ASN,1,20,208,209
373,LYS,3,60,168,171
374,LEU,68,1360,211,279
375,ILE,4,80,274,278
377,THR,26,520,173,199
378,VAL,90,1800,120,210
381,PHE,231,4620,359,590
382,CYS,2,40,248,250
384,MET,13,260,1214,1227
385,LEU,4,80,327,331
388,LEU,130,2600,680,810
389,ASN,1,20,461,462
391,THR,136,2720,689,825
392,VAL,223,4460,439,662
393,ASP,13,260,868,881
395,ILE,691,13820,343,1034
396,ILE,118,2360,581,699
398,ALA,1,20,369,370
399,LEU,94,1880,445,539
400,ARG,87,1740,482,569
408,PHE,25,500,861,886
409,ARG,6,120,869,875
411,MET,1,20,847,848
412,PHE,65,1300,1213,1278
413,PRO,18,360,762,780
